-18
19
-11
13
00000000000000000000000000000000000000
00000000000000000000000000000000000000
01000000000000100000000000000000000000
01000000000000100000000000000111110000
01000000000000100000000000111100000000
01000111111000100000000001100000000000
01000100001000100000000001000000000000
01010100001000100000000011000000000000
01010100000000100000000010000000000000
01000100000000100000000011000000000000
01000000000000100000000001000000000000
01111111111111100000000001000000000000
00000000000000000000000000000000000000
00000000000000000000000000000000000000
00000000000000000000000000000000000000
00000000000000000000000000000000000000
00000001000000000000001110011000111000
00000001000000000000000111111111111000
00000001000000000000001111111111111000
01111111111111111000001111100111111000
00000001000000000000001111110111111100
00000001000000000000000111000111111000
00000001000000000000000110000011110000
00000001000000000000000000000111000000
00000001000000000000000000000000000000
