-18
19
-11
13
0 0 0 0 0 0 0 0 0 0 0 0 0 0 0 0 0 0 0 0 0 0 0 0 0 0 0 0 0 0 0 0 0 0 0 0 0 0 
1 1 1 1 1 1 1 1 1 1 1 1 1 1 1 1 1 1 2 2 2 2 2 2 2 2 2 2 2 2 2 2 2 2 2 2 2 0 
1 0 3 3 3 3 3 3 3 3 3 3 3 3 0 1 1 1 2 2 2 2 2 2 2 2 2 2 2 2 2 2 2 2 2 2 2 0 
1 0 3 3 3 3 3 3 3 3 3 3 3 3 0 1 1 1 2 2 2 2 2 2 2 2 2 2 2 0 0 0 0 0 2 2 2 0 
1 0 3 3 3 3 3 3 3 3 3 3 3 3 0 1 1 1 2 2 2 2 2 2 2 2 0 0 0 0 2 2 2 2 2 2 2 0 
1 0 3 3 3 0 0 0 0 0 0 3 3 3 0 1 1 1 2 2 2 2 2 2 2 0 0 2 2 2 2 2 2 2 2 2 2 0 
1 0 3 3 3 0 3 3 3 3 0 3 3 3 0 1 1 1 2 2 2 2 2 2 2 0 2 2 2 2 2 2 2 2 2 2 2 0 
1 0 3 0 3 0 3 3 3 3 0 3 3 3 0 1 1 1 2 2 2 2 2 2 0 0 2 2 2 2 2 2 2 2 2 2 2 0 
1 0 3 0 3 0 3 3 3 3 3 3 3 3 0 1 1 1 2 2 2 2 2 2 0 2 2 2 2 2 2 2 2 2 2 2 2 0 
1 0 3 3 3 0 3 3 3 3 3 3 3 3 0 1 1 1 2 2 2 2 2 2 0 0 2 2 2 2 2 2 2 2 2 2 2 0 
1 0 3 3 3 3 3 3 3 3 3 3 3 3 0 1 1 1 2 2 2 2 2 2 2 0 2 2 2 2 2 2 2 2 2 2 2 0 
1 0 0 0 0 0 0 0 0 0 0 0 0 0 0 1 1 1 2 2 2 2 2 2 2 0 2 2 2 2 2 2 2 2 2 2 2 0 
1 1 1 1 1 1 1 1 1 1 1 1 1 1 1 1 1 1 2 2 2 2 2 2 2 2 2 2 2 2 2 2 2 2 2 2 2 0 
1 1 1 1 1 1 1 1 1 1 1 1 1 1 1 1 1 1 2 2 2 2 2 2 2 2 2 2 2 2 2 2 2 2 2 2 2 0 
4 4 4 4 4 4 4 4 4 4 4 4 4 4 4 4 4 4 5 5 5 5 5 5 5 5 5 5 5 5 5 5 5 5 5 5 5 0 
4 4 4 4 4 4 4 4 4 4 4 4 4 4 4 4 4 4 5 5 5 5 5 5 5 5 5 5 5 5 5 5 5 5 5 5 5 0 
4 4 4 4 4 4 4 0 4 4 4 4 4 4 4 4 4 4 5 5 5 5 0 0 0 5 5 0 0 5 5 5 0 0 0 6 6 0 
4 4 4 4 4 4 4 0 4 4 4 4 4 4 4 4 4 4 5 5 5 5 5 0 0 0 0 0 0 0 0 0 0 0 0 6 6 0 
4 4 4 4 4 4 4 0 4 4 4 4 4 4 4 4 4 4 5 5 5 5 0 0 0 0 0 0 0 0 0 0 0 0 0 6 6 0 
7 0 0 0 0 0 0 0 0 0 0 0 0 0 0 0 0 4 5 5 5 5 0 0 0 0 0 6 6 0 0 0 0 0 0 6 6 0 
7 7 7 7 7 7 7 0 4 4 4 4 4 4 4 4 4 4 5 5 5 5 0 0 0 0 0 0 6 0 0 0 0 0 0 0 6 0 
7 7 7 7 7 7 7 0 4 4 4 4 4 4 4 4 4 4 5 5 5 5 6 0 0 0 6 6 6 0 0 0 0 0 0 6 6 0 
7 7 7 7 7 7 7 0 4 4 4 4 4 4 4 4 4 4 5 5 5 5 6 0 0 6 6 6 6 6 0 0 0 0 6 6 6 0 
7 7 7 7 7 7 7 0 4 4 4 4 4 4 4 4 4 4 5 5 5 5 6 6 6 6 6 6 6 0 0 0 6 6 6 6 6 0 
7 7 7 7 7 7 7 0 4 4 4 4 4 4 4 4 4 4 5 5 5 5 6 6 6 6 6 6 6 6 6 6 6 6 6 6 6 0 
7
1 1 0 
1 2 0 
1 3 0 
1 4 0 
1 5 1 2 
1 6 2 2 5 
1 7 1 4 
2 1 0 
2 2 0 
2 3 1 1 
2 4 1 1 
2 5 0 
2 6 1 5 
2 7 2 1 4 
3 1 0 
3 2 1 1 
3 3 0 
3 4 1 1 
3 5 2 1 2 
3 6 3 1 2 5 
3 7 2 1 4 
4 1 0 
4 2 1 1 
4 3 1 1 
4 4 0 
4 5 0 
4 6 1 5 
4 7 0 
5 1 1 2 
5 2 0 
5 3 2 2 1 
5 4 0 
5 5 0 
5 6 0 
5 7 1 4 
6 1 2 5 2 
6 2 1 5 
6 3 3 5 2 1 
6 4 1 5 
6 5 0 
6 6 0 
6 7 2 5 4 
7 1 1 4 
7 2 2 4 1 
7 3 2 4 1 
7 4 0 
7 5 1 4 
7 6 2 4 5 
7 7 0 
