-18
19
-11
13
0 0 0 0 0 0 0 0 0 0 0 0 0 0 0 0 0 0 0 0 0 0 0 0 0 0 0 0 0 0 0 0 0 0 0 0 0 0 
1 1 1 1 1 1 1 1 1 1 1 1 1 1 1 1 1 1 2 2 2 2 2 2 2 2 2 2 2 2 2 2 2 2 2 2 2 0 
1 0 3 3 3 3 3 3 3 3 3 3 3 3 0 1 1 1 2 2 2 2 2 2 2 2 2 2 2 2 2 2 2 2 2 2 2 0 
1 0 3 3 3 3 3 3 3 3 3 3 3 3 0 1 1 1 2 2 2 2 2 2 2 2 2 2 2 8 8 8 8 8 2 2 2 0 
1 0 3 3 3 3 3 3 3 3 3 3 3 3 0 1 1 1 2 2 2 2 2 2 2 2 8 8 8 8 2 2 2 2 2 2 2 0 
1 0 3 3 3 0 0 0 0 8 0 3 3 3 0 1 1 1 2 2 2 2 2 2 2 8 8 2 2 2 2 2 2 2 2 2 2 0 
1 0 3 3 3 0 3 3 3 3 0 3 3 3 0 1 1 1 2 2 2 2 2 2 2 8 2 2 2 2 2 2 2 2 2 2 2 0 
1 0 3 0 3 0 3 3 3 3 0 3 3 3 0 1 1 1 2 2 2 2 2 2 8 8 2 2 2 2 2 2 2 2 2 2 2 0 
1 0 3 0 3 0 3 3 3 3 3 3 3 3 0 1 1 1 2 2 2 2 2 2 8 2 2 2 2 2 2 2 2 2 2 2 2 0 
1 0 3 3 3 0 3 3 3 3 3 3 3 3 0 1 1 1 2 2 2 2 2 2 8 8 2 2 2 2 2 2 2 2 2 2 2 0 
1 0 3 3 3 3 3 3 3 3 3 3 3 3 0 1 1 1 2 2 2 2 2 2 2 8 2 2 2 2 2 2 2 2 2 2 2 0 
1 0 0 0 0 0 0 0 0 0 0 0 0 0 0 1 1 1 2 2 2 2 2 2 2 8 2 2 2 2 2 2 2 2 2 2 2 0 
1 1 1 1 1 1 1 1 1 1 1 1 1 1 1 1 1 1 2 2 2 2 2 2 2 2 2 2 2 2 2 2 2 2 2 2 2 0 
1 1 1 1 1 1 1 1 1 1 1 1 1 1 1 1 1 1 2 2 2 2 2 2 2 2 2 2 2 2 2 2 2 2 2 2 2 0 
4 4 4 4 4 4 4 4 4 4 4 4 4 4 4 4 4 4 5 5 5 5 5 5 5 5 5 5 5 5 5 5 5 5 5 5 5 0 
4 4 4 4 4 4 4 4 4 4 4 4 4 4 4 4 4 4 5 5 5 5 5 5 5 5 5 5 5 5 5 5 5 5 5 5 5 0 
4 4 4 4 4 4 4 8 4 4 4 4 4 4 4 4 4 4 5 5 5 5 8 8 8 5 5 8 8 5 5 5 8 8 8 6 6 0 
4 4 4 4 4 4 4 8 4 4 4 4 4 4 4 4 4 4 5 5 5 5 5 8 8 8 8 8 8 8 8 8 8 8 8 6 6 0 
4 4 4 4 4 4 4 8 4 4 4 4 4 4 4 4 4 4 5 5 5 5 8 8 8 8 8 8 8 8 8 8 8 8 8 6 6 0 
7 8 8 8 8 8 8 8 8 8 8 8 8 8 8 8 8 4 5 5 5 5 8 8 8 8 8 6 6 8 8 8 8 8 8 6 6 0 
7 7 7 7 7 7 7 8 4 4 4 4 4 4 4 4 4 4 5 5 5 5 8 8 8 8 8 8 6 8 8 8 8 8 8 8 6 0 
7 7 7 7 7 7 7 8 4 4 4 4 4 4 4 4 4 4 5 5 5 5 6 8 8 8 6 6 6 8 8 8 8 8 8 6 6 0 
7 7 7 7 7 7 7 8 4 4 4 4 4 4 4 4 4 4 5 5 5 5 6 8 8 6 6 6 6 6 8 8 8 8 6 6 6 0 
7 7 7 7 7 7 7 8 4 4 4 4 4 4 4 4 4 4 5 5 5 5 6 6 6 6 6 6 6 8 8 8 6 6 6 6 6 0 
7 7 7 7 7 7 7 8 4 4 4 4 4 4 4 4 4 4 5 5 5 5 6 6 6 6 6 6 6 6 6 6 6 6 6 6 6 0 
8 7
1 3
1 2
1 4
2 5
4 7
4 5
5 6
