-18
19
-11
13
0 0 0 0 0 0 0 0 0 0 0 0 0 0 0 0 0 0 0 0 0 0 0 0 0 0 0 0 0 0 0 0 0 0 0 0 0 0 
1 1 1 1 1 1 1 1 1 1 1 1 1 1 1 1 1 1 2 2 2 2 2 2 2 2 2 2 2 2 2 2 2 2 2 2 2 0 
1 0 3 3 3 3 3 3 3 3 3 3 3 3 0 1 1 1 2 2 2 2 2 2 2 2 2 2 2 2 2 2 2 2 2 2 2 0 
1 0 3 3 3 3 3 3 3 3 3 3 3 3 0 1 1 1 2 2 2 2 2 2 2 2 2 2 2 0 0 0 0 0 2 2 2 0 
1 0 3 3 3 3 3 3 3 3 3 3 3 3 0 1 1 1 2 2 2 2 2 2 2 2 0 0 0 0 2 2 2 2 2 2 2 0 
1 0 3 3 3 0 0 0 0 0 0 3 3 3 0 1 1 1 2 2 2 2 2 2 2 0 0 2 2 2 2 2 2 2 2 2 2 0 
1 0 3 3 3 0 3 3 3 3 0 3 3 3 0 1 1 1 2 2 2 2 2 2 2 0 2 2 2 2 2 2 2 2 2 2 2 0 
1 0 3 0 3 0 3 3 3 3 0 3 3 3 0 1 1 1 2 2 2 2 2 2 0 0 2 2 2 2 2 2 2 2 2 2 2 0 
1 0 3 0 3 0 3 3 3 3 3 3 3 3 0 1 1 1 2 2 2 2 2 2 0 2 2 2 2 2 2 2 2 2 2 2 2 0 
1 0 3 3 3 0 3 3 3 3 3 3 3 3 0 1 1 1 2 2 2 2 2 2 0 0 2 2 2 2 2 2 2 2 2 2 2 0 
1 0 3 3 3 3 3 3 3 3 3 3 3 3 0 1 1 1 2 2 2 2 2 2 2 0 2 2 2 2 2 2 2 2 2 2 2 0 
1 0 0 0 0 0 0 0 0 0 0 0 0 0 0 1 1 1 2 2 2 2 2 2 2 0 2 2 2 2 2 2 2 2 2 2 2 0 
1 1 1 1 1 1 1 1 1 1 1 1 1 1 1 1 1 1 2 2 2 2 2 2 2 2 2 2 2 2 2 2 2 2 2 2 2 0 
1 1 1 1 1 1 1 1 1 1 1 1 1 1 1 1 1 1 2 2 2 2 2 2 2 2 2 2 2 2 2 2 2 2 2 2 2 0 
4 4 4 4 4 4 4 4 4 4 4 4 4 4 4 4 4 4 5 5 5 5 5 5 5 5 5 5 5 5 5 5 5 5 5 5 5 0 
4 4 4 4 4 4 4 4 4 4 4 4 4 4 4 4 4 4 5 5 5 5 5 5 5 5 5 5 5 5 5 5 5 5 5 5 5 0 
4 4 4 4 4 4 4 0 4 4 4 4 4 4 4 4 4 4 5 5 5 5 0 0 0 5 5 0 0 5 5 5 0 0 0 6 6 0 
4 4 4 4 4 4 4 0 4 4 4 4 4 4 4 4 4 4 5 5 5 5 5 0 0 0 0 0 0 0 0 0 0 0 0 6 6 0 
4 4 4 4 4 4 4 0 4 4 4 4 4 4 4 4 4 4 5 5 5 5 0 0 0 0 0 0 0 0 0 0 0 0 0 6 6 0 
7 0 0 0 0 0 0 0 0 0 0 0 0 0 0 0 0 4 5 5 5 5 0 0 0 0 0 6 6 0 0 0 0 0 0 6 6 0 
7 7 7 7 7 7 7 0 4 4 4 4 4 4 4 4 4 4 5 5 5 5 0 0 0 0 0 0 6 0 0 0 0 0 0 0 6 0 
7 7 7 7 7 7 7 0 4 4 4 4 4 4 4 4 4 4 5 5 5 5 6 0 0 0 6 6 6 0 0 0 0 0 0 6 6 0 
7 7 7 7 7 7 7 0 4 4 4 4 4 4 4 4 4 4 5 5 5 5 6 0 0 6 6 6 6 6 0 0 0 0 6 6 6 0 
7 7 7 7 7 7 7 0 4 4 4 4 4 4 4 4 4 4 5 5 5 5 6 6 6 6 6 6 6 0 0 0 6 6 6 6 6 0 
7 7 7 7 7 7 7 0 4 4 4 4 4 4 4 4 4 4 5 5 5 5 6 6 6 6 6 6 6 6 6 6 6 6 6 6 6 0 
7
1 1 
2 1 2 
2 1 3 
2 1 4 
3 1 2 5 
4 1 2 5 6 
3 1 4 7 
2 2 1 
1 2 
3 2 1 3 
3 2 1 4 
2 2 5 
3 2 5 6 
4 2 1 4 7 
2 3 1 
3 3 1 2 
1 3 
3 3 1 4 
4 3 1 2 5 
5 3 1 2 5 6 
4 3 1 4 7 
2 4 1 
3 4 1 2 
3 4 1 3 
1 4 
2 4 5 
3 4 5 6 
2 4 7 
3 5 2 1 
2 5 2 
4 5 2 1 3 
2 5 4 
1 5 
2 5 6 
3 5 4 7 
4 6 5 2 1 
3 6 5 2 
5 6 5 2 1 3 
3 6 5 4 
2 6 5 
1 6 
4 6 5 4 7 
3 7 4 1 
4 7 4 1 2 
4 7 4 1 3 
2 7 4 
3 7 4 5 
4 7 4 5 6 
1 7 
