-1
6
-1
5
00000000
00000000
00000000
10010000
01000000
00100000
10011110
