-18
19
-11
13
00000000000000000000000000000000000000
11111111111111111122222222222222222220
10333333333333011122222222222222222220
10333333333333011122222222222000002220
10333333333333011122222222000022222220
10333000000333011122222220022222222220
10333033330333011122222220222222222220
10303033330333011122222200222222222220
10303033333333011122222202222222222220
10333033333333011122222200222222222220
10333333333333011122222220222222222220
10000000000000011122222220222222222220
11111111111111111122222222222222222220
11111111111111111122222222222222222220
44444444444444444455555555555555555550
44444444444444444455555555555555555550
44444440444444444455550005500555000660
44444440444444444455555000000000000660
44444440444444444455550000000000000660
70000000000000000455550000066000000660
77777770444444444455550000006000000060
77777770444444444455556000666000000660
77777770444444444455556006666600006660
77777770444444444455556666666000666660
77777770444444444455556666666666666660
7 7
1 3
1 2
1 4
2 5
4 7
4 5
5 6
